
F 171, 170, 169
C 119,181,254


WE assets/textures/bedrock.xpm
NO assets/textures/cobblestone.xpm
SO assets/textures/stone_bricks.xpm
EA assets/textures/oak_planks.xpm


1111111111111111111
1000000001001000001
1010111101000001001
1010100001111101111
1011111000001001001
10001010000W0001001
1011101111101001001
1010000001001101011
1000111000010000001
1111111111111111111
