
F 76, 76,76
C 999,999,9999


SO assets/textures/mossy.xpm
NO assets/textures/wood.xpm
EA assets/textures/stone.xpm
WE assets/textures/brick.xpm


1111111111111111111
1000000001001000001
1010111101000001001
1010100001111101111
1011111000001001001
100010100S000001001
1011101111101001001
1010000001001101011
1000111000010000001
1111111111111111111
