
F 255,255,255
C 119,181,254


EA assets/textures/mossy.xpm
SO assets/textures/mossy.xpm
NO assets/textures/wood.xpm
WE assets/textures/brick.xpm


1111111111111111111
1000000001001000001
1010111101000001001
101010W001111101111
1011111000001001001
1000101000000001001
1011101111101001001
1010000001001101011
1000111000010000001
1111111111111111111
