F 76,76,76
C 99,99,99

NO ./path_to_the_north_texture
SO ./path_to_the_south_texture
WE ./path_to_the_west_texture
EA ./path_to_the_east_texture

1111111111111111111
1000000001001000001
1010111101000001001
1010100001111101111
1011111000001001001
1000101000000001001
1011101111101001001
1010000000001101011
1000111001000000001
1111111111111111111
