NO assets/textures/brick.xpm
SO assets/textures/stone.xpm
WE assets/textures/wood.xpm
EA assets/textures/mossy.xpm

F 220,100,0
C 225,30,0


11111111111111111111111111111
10000000001100000000000000001
10110000011100000000000000001
10010000000000000000000000001
11111111101100000111000000001
10000000001100000111000111111
11110111111111011100000010001
11110111111111011101010010001
11000000110101011100000010001
10000000000000001100000010001
10000000000000001101010010001
110000011101010111110110S0111
11110111111110101101111010001
11111111111111111111111111111
