NO assets/textures/brick.xpm
SO assets/textures/stone.xpm

F 220,100,0

WE assets/textures/wood.xpm
SO assets/textures/sto



D 300,30,0


10000000001100000000000000001
10110000011100000000000000001
10010000000000000000000000001
11111111101100000111000000001
10000000001100000111000111111
11110111111111011100000010001
11110111111111011101010010001
11000000110101011100000010001
10000000000000001100000010001
10000000000000001101010010001
11000001110101011111011000111
11110111111110101101111010
11111111111111111111111111111
